10 10
0001100011
1100011000
1110001110
1000010000
0000000000
0001100011
1100011000
1110001110
1000010000
0000000000
2 1
2 1 100
1 4 100
0 0
4 4